###    ######    ###
###      ##      ###
##     ##  ##     ##
#      ##  ##      #
##                ##
#####          #####
###### ##  ##  #####
 #     ######     # 
     #######        
    ############    
    ############    
     ########      #
 #     ######     ##
###### ##  ## ######
#####          #####
##                ##
#   ## #    # ##   #
##   ##      ##   ##
###    #    #    ###
###    ######    ###